8
########
#0F00F0#	
#00###FE 
S0F0000#
#000F#F#
#0F#0#0#
#00#0FT#
########